HighBurnSeverity|GeoWEPP\High severity fire-sandy loam.sol
LowBurnSeverity|GeoWEPP\Low severity fire-sandy loam.sol
Nodata|GeoWEPP\20-yr forest sandy loam.sol
Unburned|GeoWEPP\20-yr forest sandy loam.sol
ModerateBurnSeverity|GeoWEPP\Low severity fire-sandy loam.sol
ALLISON|in\ALLISON(SICL).sol
BATTLEGROUND|in\BATTLEGROUND(SIL).sol
BILLETT|in\BILLETT(SL).sol
BOWES|KEITH.sol
BOWESVARIANT|KEITH.sol
BRENTON|in\BRENTON(SIL).sol
CAMDEN|in\CAMDEN(SIL).sol
CARMI|in\CARMI(SL).sol
CERESCO|in\CERESCO(SL).sol
CHALMERS|in\CHALMERS(SICL).sol
COHOCTAH|in\COHOCTAH(FSL).sol
COLOMA|in\COLOMA(LS).sol
CROSBY|in\CROSBY(SIL).sol
DESKER|KEITH.sol
DRUMMER|in\DRUMMER(SICL).sol
DUPAGE|in\DUPAGE(SIL).sol
ELSTON|in\ELSTON(SL).sol
FINCASTLE|in\FINCASTLE(SIL).sol
HIGHGAPVARIANT|in\HIGH GAP VARIANT(SIL).sol
HONONEGAH|in\HONONEGAH(LCOS).sol
HOUGHTON|KEITH.sol
KALAMAZOO|in\KALAMAZOO(L).sol
KOSCIUSKO|in\KOSCIUSKO(SL).sol
LAFAYETTE|in\LAFAYETTE(SIL).sol
LAHOGUE|in\LA HOGUE(L).sol
LASH|KEITH.sol
LAURAMIE|in\LAURAMIE(SIL).sol
LONGLOIS|in\LONGLOIS(SIL).sol
MAHALASVILLE|in\MAHALASVILLE(SICL).sol
MELLOTT|in\MELLOTT(SIL).sol
MIAMI|in\MIAMI(SIL).sol
MILFORD|in\MILFORD(SICL).sol
MULVEY|KEITH.sol
MUSKEGO|KEITH.sol
OCKLEY|in\OCKLEY(SIL).sol
OCTAGON|in\OCTAGON(SIL).sol
OUIATENON|in\OUIATENON(LS).sol
PALMS|KEITH.sol
PELLA|in\PELLA(SICL).sol
PEOTONE|in\PEOTONE(SICL).sol
PINEVILLAGE|KEITH.sol
PITS|KEITH.sol
RAINSVILLE|in\RAINSVILLE(SIL).sol
RICHARDVILLE|in\RICHARDVILLE(SIL).sol
ROCKFIELD|in\ROCKFIELD(SIL).sol
RODMAN|in\RODMAN(GR-L).sol
SARANAC|in\SARANAC(CL).sol
SAWABASH|KEITH.sol
SLEETH|in\SLEETH(L).sol
SLOAN|in\SLOAN(SIL).sol
SPARTA|in\SPARTA(LFS).sol
SPINKS|in\SPINKS(LS).sol
THACKERY|in\THACKERY(SIL).sol
THROCKMORTON|in\THROCKMORTON(SIL).sol
TICE|in\TICE(SICL).sol
TORONTO|in\TORONTO(SIL).sol
TREATY|in\TREATY(SIL).sol
TROXEL|in\TROXEL(SIL).sol
UDORTHENTS|in\UDORTHENTS(CL).sol
URBANLAND|pavement.sol
WALLKILL|KEITH.sol
WASHTENAW|in\WASHTENAW(SIL).sol
WATER,CENSUS|in\WATER,CENSUS.sol
WATER,NONCENSUS|in\WATER,NONCENSUS.sol
WAUPECAN|KEITH.sol
WAYNETOWN|in\WAYNETOWN(SIL).sol
WEA|in\WEA(SIL).sol
WHITAKER|in\WHITAKER(L).sol